00000000000000000000
01111111101100000000
01111111101111111000
01111111101100000000
00000000000000000000
00011111111100000000
00000011111111000000
00000000011111111000
00001111111111100000
00000001111111100000
00001111111111111111
00000000000000000000
11111111111111110000